1 1 1 1 1 1 1 1 1 1 1 1 1 1 1 1 1 1 1 1 1 1 1 1 1 1 1 1 1 1 1
1 0 0 2 0 0 0 0 0 0 0 0 0 0 0 0 0 0 0 0 0 0 0 0 0 0 0 0 0 0 1
1 0 1 2 1 0 1 0 1 2 1 0 1 0 1 0 1 0 1 0 1 0 1 2 1 2 1 0 1 0 1
1 0 2 2 0 0 0 0 0 2 0 0 2 0 0 0 0 0 0 2 0 0 0 2 2 2 0 0 0 0 1
1 2 1 5 1 0 1 0 1 2 1 0 1 0 1 0 1 0 1 0 1 0 1 0 1 0 1 0 1 0 1
1 0 0 0 2 0 0 0 0 0 0 0 0 0 0 0 0 0 2 0 0 0 0 2 2 2 6 0 0 0 1
1 0 1 0 1 0 1 2 1 0 1 0 1 0 1 0 1 0 1 2 1 0 1 2 1 2 1 0 1 0 1
1 0 2 2 0 0 2 2 2 0 0 0 0 0 0 2 2 2 2 2 2 0 0 0 0 0 0 0 0 0 1
1 2 1 0 1 0 1 2 1 0 1 0 1 2 1 0 1 0 1 2 1 0 1 0 1 0 1 0 1 0 1
1 0 0 5 0 0 0 0 0 0 0 0 2 2 2 0 0 0 0 0 2 2 0 0 0 0 0 0 0 0 1
1 0 1 0 1 0 1 0 1 0 1 2 1 2 1 0 1 0 1 0 1 0 1 2 1 0 1 0 1 0 1
1 0 0 0 0 0 0 2 2 2 0 0 2 2 2 0 0 2 7 2 0 0 0 6 0 0 0 0 0 0 1
1 0 1 0 1 0 1 0 1 0 1 0 1 0 1 0 1 0 1 0 1 0 1 0 1 0 1 0 1 0 1
1 0 0 0 0 2 0 0 0 0 0 2 2 2 0 0 2 2 2 0 0 0 0 2 0 2 0 2 0 0 1
1 0 1 0 1 2 1 0 1 0 1 2 1 2 1 0 1 0 1 2 1 0 1 0 1 0 1 0 1 0 1
1 0 0 0 0 2 2 2 2 0 0 0 0 0 0 0 0 2 2 2 2 2 2 0 0 0 0 0 0 0 1
1 0 1 0 1 2 1 0 1 0 1 0 1 2 1 0 1 0 1 2 1 0 1 0 1 0 1 0 1 0 1
1 0 0 2 2 2 2 0 0 0 0 0 2 2 2 0 0 2 2 0 0 2 0 0 0 0 2 2 0 2 1
1 0 1 0 1 0 1 0 1 0 1 0 1 2 1 0 1 0 1 0 1 0 1 0 1 0 1 0 1 2 1
1 0 0 0 0 0 0 0 0 0 0 0 0 0 0 0 0 0 0 0 0 0 0 0 0 0 2 2 0 3 1
1 1 1 1 1 1 1 1 1 1 1 1 1 1 1 1 1 1 1 1 1 1 1 1 1 1 1 1 1 1 1