1 1 1 1 1 1 1 1 1 1 1 1 1 1 1 1 1 1 1 1 1 1 1 1
1 1 1 1 1 1 1 1 1 1 1 1 1 1 1 1 1 1 1 1 1 1 1 1
1 1 0 0 0 0 0 0 0 0 0 0 0 0 0 0 0 0 1 1 1 1 1 1
1 1 0 0 0 0 0 0 0 0 0 0 0 0 0 0 0 0 1 1 1 1 1 1
1 1 0 0 0 0 0 0 0 0 0 0 0 0 0 3 3 3 1 1 1 1 1 1
1 1 0 0 0 0 0 0 0 0 0 0 0 0 0 3 3 4 1 1 1 1 1 1
1 1 0 0 0 1 1 3 3 3 3 3 0 0 0 3 3 3 1 1 1 1 1 1
1 1 0 0 0 1 3 3 3 3 3 3 3 3 3 3 0 0 1 1 1 1 1 1
1 1 0 0 0 1 3 3 3 3 0 0 3 3 3 3 0 0 1 1 1 1 1 1
1 1 0 0 0 3 3 3 3 1 0 0 3 3 3 3 0 0 1 1 1 1 1 1
1 1 3 3 3 3 3 3 3 1 0 0 3 3 3 3 0 0 1 1 1 1 1 1
1 1 3 2 3 0 0 0 0 0 0 0 0 0 0 0 0 0 1 1 1 1 1 1
1 1 3 3 1 0 0 0 0 0 0 0 0 0 0 0 0 0 1 1 1 1 1 1
1 1 1 1 1 1 1 1 1 1 1 1 1 1 1 1 1 1 1 1 1 1 1 1
1 1 1 1 1 1 1 1 1 1 1 1 1 1 1 1 1 1 1 1 1 1 1 1
11 2